Timestamp,Attempt No,Time to Preprocess (millis),Time to Classify (millis),,,,
,5,11,123,,,,134
,11,23,131,,,,154
,16,29,155,,,,184
,22,38,139,,,,177
,27,17,137,,,,154
,32,19,139,,,,158
,38,33,144,,,,177
,43,16,141,,,,157
,48,31,139,,,,170
,54,20,142,,,,162
,59,22,141,,,,163
,64,36,141,,,,177
,69,13,142,,,,155
,75,23,139,,,,162
,80,18,139,,,,157
,85,28,161,,,,189
,91,23,158,,,,181
,96,25,151,,,,176
,101,39,140,,,,179
,106,20,148,,,,168
,111,13,176,,,,189
,116,29,159,,,,188
,122,15,142,,,,157
,127,13,140,,,,153
,133,16,167,,,,183
,138,22,143,,,,165
,142,35,138,,,,173
,148,13,160,,,,173
,154,14,156,,,,170
,159,20,137,,,,157
,164,14,140,,,,154
,170,30,154,,,,184
,175,20,146,,,,166
,180,32,164,,,,196
,185,29,161,,,,190
,191,31,141,,,,172
,196,14,143,,,,157
,202,35,156,,,,191
,207,30,140,,,,170
,213,31,149,,,,180
,218,40,142,,,,182
,223,29,153,,,,182
,229,24,147,,,,171
,233,35,139,,,,174
,238,17,137,,,,154
,243,17,161,,,,178
,248,35,181,,,,216
,253,40,140,,,,180
,258,16,133,,,,149
,264,13,135,,,,148
,269,13,132,,,,145
,275,42,137,,,,179
,280,16,144,,,,160
,285,16,135,,,,151
,290,25,148,,,,173
,295,24,138,,,,162
,300,20,172,,,,192
,306,16,144,,,,160
,311,28,165,,,,193
,317,38,145,,,,183
,322,15,136,,,,151
,328,14,139,,,,153
,333,21,144,,,,165
,339,34,140,,,,174
,344,30,148,,,,178
,349,33,151,,,,184
,354,14,136,,,,150
,359,13,135,,,,148
,365,15,138,,,,153
,370,16,137,,,,153
,375,30,138,,,,168
,381,15,140,,,,155
,386,15,137,,,,152
,391,39,138,,,,177
,396,19,139,,,,158
,401,37,161,,,,198
,407,33,139,,,,172
,412,35,150,,,,185
,418,20,137,,,,157
,423,23,142,,,,165
,429,13,137,,,,150
,434,32,146,,,,178
,439,33,133,,,,166
,445,26,166,,,,192
,451,14,136,,,,150
,456,29,143,,,,172
,462,19,134,,,,153
,467,37,138,,,,175
,472,13,168,,,,181
,477,23,139,,,,162
,483,30,144,,,,174
,488,14,139,,,,153
,494,14,136,,,,150
,500,14,140,,,,154
,505,14,140,,,,154
,511,24,143,,,,167
,516,14,158,,,,172
,521,15,141,,,,156
,526,22,150,,,,172
,532,20,167,,,,187
,537,32,149,,,,181
,542,28,151,,,,179
,547,23,146,,,,169
,552,24,148,,,,172
,556,21,149,,,,170
,562,19,149,,,,168
,567,15,145,,,,160
,572,24,149,,,,173
,577,23,180,,,,203
,581,23,162,,,,185
,586,25,146,,,,171
,591,26,169,,,,195
,596,36,146,,,,182
,601,14,149,,,,163
,606,33,159,,,,192
,611,20,147,,,,167
,616,23,156,,,,179
,620,25,169,,,,194
,625,25,152,,,,177
,630,15,147,,,,162
,635,15,155,,,,170
,640,21,152,,,,173
,645,15,142,,,,157
,650,18,145,,,,163
,655,38,149,,,,187
,659,33,153,,,,186
,665,34,154,,,,188
,669,18,158,,,,176
,675,33,147,,,,180
,680,29,155,,,,184
,685,15,144,,,,159
,690,16,152,,,,168
,695,33,149,,,,182
,699,24,150,,,,174
,704,29,146,,,,175
,709,16,153,,,,169
,714,32,158,,,,190
,719,16,145,,,,161
,725,26,146,,,,172
,730,17,148,,,,165
,735,22,146,,,,168
,739,15,165,,,,180
,744,30,177,,,,207
,749,41,149,,,,190
,754,36,143,,,,179
,759,15,149,,,,164
,765,15,148,,,,163
,770,24,171,,,,195
,774,17,203,,,,220
,779,15,146,,,,161
,785,21,161,,,,182
,789,18,174,,,,192
,794,34,154,,,,188
,800,15,149,,,,164
,805,19,147,,,,166
,810,15,146,,,,161
,815,20,153,,,,173
,819,27,157,,,,184
,824,36,152,,,,188
,829,45,158,,,,203
,834,16,146,,,,162
,839,23,168,,,,191
,844,38,149,,,,187
,849,15,176,,,,191
,853,23,174,,,,197
,859,15,151,,,,166
,864,25,160,,,,185
,869,15,169,,,,184
,874,27,154,,,,181
,879,39,152,,,,191
,884,27,181,,,,208
,889,33,184,,,,217
,894,24,153,,,,177
,899,14,148,,,,162
,904,41,158,,,,199
,909,27,153,,,,180
,914,27,157,,,,184
,919,29,154,,,,183
,924,28,158,,,,186
,929,33,164,,,,197
,934,23,156,,,,179
,939,41,176,,,,217
,944,17,151,,,,168
,948,14,142,,,,156
,953,25,160,,,,185
,958,18,178,,,,196
,963,16,149,,,,165
,968,43,150,,,,193
,973,24,152,,,,176
,978,17,154,,,,171
,983,35,151,,,,186
,988,25,156,,,,181
,993,33,190,,,,223
,998,27,156,,,,183
,1003,15,147,,,,162
,1008,18,152,,,,170
,1013,29,154,,,,183
,1018,16,155,,,,171
,1023,25,150,,,,175
,1028,31,151,,,,182
,1033,16,165,,,,181
,1038,26,153,,,,179
,1043,15,144,,,,159
,1048,25,146,,,,171
,1053,27,148,,,,175
,1058,21,157,,,,178
,1063,25,160,,,,185
,1068,24,158,,,,182
,1073,26,150,,,,176
,1078,17,157,,,,174
,1083,35,160,,,,195
,1088,31,152,,,,183
,1093,29,150,,,,179
,1098,27,152,,,,179
,1103,38,150,,,,188
,1108,15,145,,,,160
,1114,17,151,,,,168
,1119,24,152,,,,176
,1124,23,151,,,,174
,1129,20,168,,,,188
,1134,28,147,,,,175
,1139,35,167,,,,202
,1144,21,150,,,,171
,1149,16,150,,,,166
,1154,27,152,,,,179
,1159,27,164,,,,191
,1165,32,141,,,,173
,1170,16,146,,,,162
,1175,24,156,,,,180
,1180,42,159,,,,201
,1185,14,152,,,,166
,1190,24,175,,,,199
,1195,38,140,,,,178
,1200,18,154,,,,172
,1205,15,162,,,,177
,1210,17,140,,,,157
,1215,30,153,,,,183
,1220,14,155,,,,169
,1225,15,147,,,,162
,1230,34,149,,,,183
,1235,34,147,,,,181
,1241,15,161,,,,176
,1246,18,146,,,,164
,1251,24,146,,,,170
,1256,14,145,,,,159
,1261,14,146,,,,160
,1266,16,144,,,,160
,1271,15,147,,,,162
,1276,36,152,,,,188
,1281,17,149,,,,166
,1286,16,152,,,,168
,1291,15,145,,,,160
,1296,23,148,,,,171
,1301,25,147,,,,172
,1306,23,150,,,,173
,1311,43,153,,,,196
,1316,24,164,,,,188
,1320,15,157,,,,172
,1325,15,159,,,,174
,1330,23,182,,,,205
,1334,19,161,,,,180
,1339,18,176,,,,194
,1343,28,221,,,,249
,1348,17,168,,,,185
,1353,18,171,,,,189
,1357,17,168,,,,185
,1362,26,170,,,,196
,1366,19,182,,,,201
,1371,39,175,,,,214
,1375,36,197,,,,233
,1380,17,178,,,,195
,1384,33,170,,,,203
,1389,39,187,,,,226
,1394,19,179,,,,198
,1398,18,184,,,,202
,1403,19,167,,,,186
,1407,17,166,,,,183
,1412,18,172,,,,190
,1416,31,190,,,,221
,1421,21,189,,,,210
,1425,20,170,,,,190
,1430,26,173,,,,199
,1434,34,170,,,,204
,1439,17,172,,,,189
,1443,28,175,,,,203
,1448,17,196,,,,213
,1452,18,204,,,,222
,1456,34,173,,,,207
,1461,26,169,,,,195
,1465,27,180,,,,207
,1470,38,180,,,,218
,1475,18,175,,,,193
,1479,29,179,,,,208
,1483,28,176,,,,204
,1488,22,182,,,,204
,1493,17,171,,,,188
,1497,18,174,,,,192
,1502,23,177,,,,200
,1506,24,168,,,,192
,1508,17,175,,,,192