T,Attempt No,Time to Preprocess (millis),Time to Classify (millis),,,,
,17,34,4,,,,38
,41,33,2,,,,35
,66,38,2,,,,40
,90,31,2,,,,33
,111,38,5,,,,43
,132,45,1,,,,46
,150,44,1,,,,45
,166,52,2,,,,54
,183,38,1,,,,39
,201,33,1,,,,34
,220,44,2,,,,46
,239,45,1,,,,46
,259,41,0,,,,41
,279,74,1,,,,75
,299,34,1,,,,35
,318,43,1,,,,44
,336,35,1,,,,36
,355,34,2,,,,36
,372,58,1,,,,59
,389,85,0,,,,85
,410,54,2,,,,56
,429,37,0,,,,37
,448,44,1,,,,45
,468,65,1,,,,66
,487,66,1,,,,67
,505,61,0,,,,61
,523,41,0,,,,41
,543,58,1,,,,59
,562,51,0,,,,51
,581,41,1,,,,42
,601,38,0,,,,38
,618,40,0,,,,40
,636,60,1,,,,61
,656,38,0,,,,38
,676,52,3,,,,55
,694,38,2,,,,40
,714,42,2,,,,44
,734,63,0,,,,63
,753,41,0,,,,41
,773,39,2,,,,41
,793,87,1,,,,88
,811,52,0,,,,52
,830,40,1,,,,41
,851,44,0,,,,44
,867,42,1,,,,43
,886,43,0,,,,43
,901,69,0,,,,69
,919,42,0,,,,42
,937,46,1,,,,47
,955,58,0,,,,58
,972,54,0,,,,54
,991,45,2,,,,47
,1008,51,2,,,,53
,1024,49,0,,,,49
,1041,49,0,,,,49
,1057,102,1,,,,103
,1076,51,1,,,,52
,1094,52,0,,,,52
,1110,70,1,,,,71
,1127,61,0,,,,61
,1147,46,1,,,,47
,1165,53,0,,,,53
,1183,60,0,,,,60
,1199,51,2,,,,53
,1216,48,0,,,,48
,1234,67,0,,,,67
,1252,61,0,,,,61
,1269,52,0,,,,52
,1286,55,0,,,,55
,1303,99,1,,,,100
,1321,45,0,,,,45
,1338,110,1,,,,111
,1355,52,1,,,,53
,1372,47,1,,,,48
,1389,65,1,,,,66
,1407,51,1,,,,52
,1424,46,0,,,,46
,1443,45,2,,,,47
,1459,46,1,,,,47
,1477,46,0,,,,46
,1495,52,2,,,,54
,1512,50,0,,,,50
,1531,42,1,,,,43
,1551,57,0,,,,57
,1570,79,0,,,,79
,1590,61,0,,,,61
,1610,52,0,,,,52
,1633,38,0,,,,38
,1652,44,0,,,,44
,1675,58,1,,,,59
,1695,42,0,,,,42
,1714,64,1,,,,65
,1735,37,1,,,,38
,1756,38,1,,,,39
,1778,41,1,,,,42
,1800,34,0,,,,34
,1820,35,1,,,,36
,1839,36,1,,,,37
,1859,40,2,,,,42
,1879,38,1,,,,39
,1900,43,0,,,,43
,1919,38,0,,,,38
,1938,43,1,,,,44
,1956,43,0,,,,43
,1972,53,6,,,,59
,1991,41,1,,,,42
,2009,45,0,,,,45
,2027,39,2,,,,41
,2045,41,1,,,,42
,2063,43,1,,,,44
,2081,42,1,,,,43
,2100,44,1,,,,45
,2117,45,2,,,,47
,2135,47,1,,,,48
,2153,65,0,,,,65
,2170,85,0,,,,85
,2186,61,1,,,,62
,2203,63,2,,,,65
,2222,52,1,,,,53
,2240,65,0,,,,65
,2259,50,0,,,,50
,2276,49,0,,,,49
,2296,65,0,,,,65
,2312,49,0,,,,49
,2330,47,1,,,,48
,2346,48,0,,,,48
,2361,50,2,,,,52
,2377,66,1,,,,67
,2396,49,0,,,,49
,2414,46,0,,,,46
,2430,46,1,,,,47
,2447,49,0,,,,49
,2464,49,1,,,,50
,2479,51,0,,,,51
,2496,50,0,,,,50
,2511,45,1,,,,46
,2531,56,0,,,,56
,2546,82,0,,,,82
,2563,60,0,,,,60
,2580,54,3,,,,57
,2598,51,0,,,,51
,2615,60,0,,,,60
,2632,47,0,,,,47
,2652,57,1,,,,58
,2671,59,1,,,,60
,2691,43,3,,,,46
,2711,39,1,,,,40
,2730,41,1,,,,42
,2747,40,0,,,,40
,2772,41,0,,,,41
,2794,58,1,,,,59
,2816,43,0,,,,43
,2838,38,3,,,,41
,2858,44,1,,,,45
,2877,44,5,,,,49
,2897,46,0,,,,46
,2914,42,2,,,,44
,2934,44,1,,,,45
,2952,67,0,,,,67
,2969,44,1,,,,45
,2988,48,1,,,,49
,3005,62,2,,,,64
,3020,59,0,,,,59
,3035,100,0,,,,100
,3053,67,0,,,,67
,3068,96,1,,,,97
,3085,45,1,,,,46
,3102,88,0,,,,88
,3120,83,1,,,,84
,3139,43,1,,,,44
,3158,45,0,,,,45
,3175,43,0,,,,43
,3192,46,0,,,,46
,3209,52,0,,,,52
,3227,50,0,,,,50
,3245,46,0,,,,46
,3262,55,0,,,,55
,3281,57,0,,,,57
,3300,45,0,,,,45
,3317,57,3,,,,60
,3334,54,1,,,,55
,3352,71,2,,,,73
,3369,50,0,,,,50
,3387,43,5,,,,48
,3404,53,0,,,,53
,3419,72,1,,,,73
,3437,87,0,,,,87
,3455,53,1,,,,54
,3474,45,1,,,,46
,3493,46,0,,,,46
,3511,45,0,,,,45
,3528,47,1,,,,48
,3545,44,2,,,,46
,3563,45,1,,,,46
,3581,43,1,,,,44
,3597,42,6,,,,48
,3617,42,4,,,,46
,3636,38,0,,,,38
,3654,43,3,,,,46
,3673,42,2,,,,44
,3691,40,1,,,,41
,3710,39,1,,,,40
,3729,46,1,,,,47
,3750,36,0,,,,36
,3771,37,0,,,,37
,3793,38,0,,,,38
,3816,38,1,,,,39
,3837,42,1,,,,43
,3859,50,1,,,,51
,3879,62,2,,,,64
,3899,66,0,,,,66
,3917,41,1,,,,42
,3935,45,0,,,,45
,3952,49,1,,,,50
,3970,44,0,,,,44
,3989,46,0,,,,46
,4009,43,5,,,,48
,4028,41,0,,,,41
,4043,84,1,,,,85
,4062,67,2,,,,69
,4081,73,1,,,,74
,4097,72,3,,,,75
,4114,73,1,,,,74
,4131,91,0,,,,91
,4148,89,2,,,,91
,4165,53,1,,,,54
,4184,41,6,,,,47
,4202,58,0,,,,58
,4220,47,1,,,,48
,4237,49,1,,,,50
,4254,59,1,,,,60
,4273,62,1,,,,63
,4289,51,0,,,,51
,4307,56,1,,,,57
,4323,82,0,,,,82
,4340,55,0,,,,55
,4355,52,1,,,,53
,4370,84,1,,,,85
,4388,51,0,,,,51
,4406,48,0,,,,48
,4423,46,7,,,,53
,4441,49,1,,,,50
,4461,49,0,,,,49
,4478,48,1,,,,49
,4494,56,0,,,,56
,4510,60,0,,,,60
,4526,51,1,,,,52
,4543,57,1,,,,58
,4560,72,1,,,,73
,4577,45,0,,,,45
,4595,45,1,,,,46
,4612,47,1,,,,48
,4630,59,1,,,,60
,4649,42,1,,,,43
,4668,43,0,,,,43
,4686,57,1,,,,58
,4706,64,0,,,,64
,4724,41,0,,,,41
,4744,52,1,,,,53
,4766,28,2,,,,30
,4786,42,0,,,,42
,4806,40,1,,,,41
,4826,50,1,,,,51
,4848,40,1,,,,41
,4868,48,1,,,,49
,4888,52,1,,,,53
,4910,42,0,,,,42
,4931,41,0,,,,41
,4950,40,0,,,,40
,4970,38,3,,,,41
,4989,50,1,,,,51
,5008,50,1,,,,51
,5025,61,1,,,,62
,5042,51,0,,,,51
,5059,49,0,,,,49
,5076,66,1,,,,67
,5092,58,1,,,,59
,5112,57,3,,,,60
,5128,46,1,,,,47
,5147,49,1,,,,50
,5164,50,2,,,,52
,5181,64,1,,,,65
,5199,46,2,,,,48
,5215,52,1,,,,53
,5233,53,0,,,,53
,5250,64,0,,,,64
,5266,49,0,,,,49
,5283,45,4,,,,49
,5300,61,1,,,,62
,5318,55,0,,,,55
,5334,73,5,,,,78
,5349,99,0,,,,99
,5367,50,0,,,,50
,5385,28,4,,,,32
,5402,51,1,,,,52
,5418,47,0,,,,47
,5434,41,2,,,,43
,5452,54,1,,,,55
,5468,47,0,,,,47
,5486,56,2,,,,58